9999999999999999999999
9000000000000003000009
9020000040222203004009
9030P00040000003000209
9030000040000003010009
9002222040000003000109
9000040040000003001009
9000400040000003000009
9003300111110000004409
9000000000000011000009
9999999999999999999999
